22222222222222222222222222222222
20001000000000000000000000000002
21001000000000000000000000000002
20001111110011110000000000000002
20000000000000010000000000000002
20001111110000010000000000000002
20001000000000010000001100000002
21111000000000010000001100000002
20000000000000010000000000000002
20000000000000010000000000000002
20000010000000010000000000000002
20000000000000000000000000000002
20000000000000000000000000000002
20001111000000000000000000000002
20001111000000010000000001000002
20001111000000010000000000000002
20000000000000010000000000000002
22222222222222222222222222222222
