00000000000000000000000000000000
00000000000000000000000000000000
00000000000000000000000000000000
00000000000000000000000000000000
00000000000000000000000000000000
00000000000000000000000000000000
00000000000000000000000000000000
00000000000000000000000000000000
00000000000000002222222222200000
00000000000000000000000000000000
00000000000000000000000000000000
00022222222200000000000000000000
00000000000000000000000000000000
00000000000000000000000000000000
22222222222222222222222222222222
11111111111111111111111111111111
11111111111111111111111111111111
11111111111111111111111111111111